//MAP CONVERTED BY dmm2tgm.py THIS HEADER COMMENT PREVENTS RECONVERSION, DO NOT REMOVE
"aa" = (
/turf/template_noop,
/area/template_noop)
"ac" = (
/obj/effect/spawner/structure/window/shuttle,
/turf/open/floor/plating,
/area/shuttle/escape)
"ad" = (
/turf/closed/wall/mineral/titanium,
/area/shuttle/escape)
"ae" = (
/turf/closed/wall/mineral/titanium/interior,
/area/shuttle/escape)
"af" = (
/obj/effect/turf_decal/trimline/neutral/filled/corner{
	dir = 4
	},
/turf/open/floor/wood,
/area/shuttle/escape)
"ah" = (
/obj/machinery/computer/emergency_shuttle,
/turf/open/floor/mineral/titanium/blue,
/area/shuttle/escape)
"al" = (
/obj/machinery/computer/atmos_alert{
	dir = 4
	},
/turf/open/floor/mineral/titanium/blue,
/area/shuttle/escape)
"an" = (
/turf/open/floor/mineral/titanium/blue,
/area/shuttle/escape)
"ap" = (
/obj/machinery/computer/security{
	dir = 8
	},
/turf/open/floor/mineral/titanium/blue,
/area/shuttle/escape)
"aq" = (
/obj/machinery/computer/crew{
	dir = 4
	},
/turf/open/floor/mineral/titanium/blue,
/area/shuttle/escape)
"au" = (
/obj/machinery/computer/communications{
	dir = 8
	},
/turf/open/floor/mineral/titanium/blue,
/area/shuttle/escape)
"ay" = (
/obj/machinery/door/airlock/public/glass{
	name = "Emergency Shuttle Cockpit";
	req_access_txt = "19"
	},
/turf/open/floor/mineral/titanium,
/area/shuttle/escape)
"aA" = (
/obj/structure/chair/comfy/shuttle,
/turf/open/floor/mineral/plastitanium/red/brig,
/area/shuttle/escape)
"aC" = (
/turf/open/floor/mineral/titanium,
/area/shuttle/escape)
"aG" = (
/turf/open/floor/mineral/plastitanium/red/brig,
/area/shuttle/escape)
"aH" = (
/obj/machinery/door/airlock/public/glass{
	name = "Emergency Shuttle Brig";
	req_access_txt = "2"
	},
/turf/open/floor/mineral/titanium,
/area/shuttle/escape)
"aI" = (
/obj/machinery/door/airlock/titanium{
	name = "Emergency Shuttle Airlock";
	req_access_txt = "2"
	},
/turf/open/floor/mineral/plastitanium/red/brig,
/area/shuttle/escape)
"aJ" = (
/obj/structure/chair/comfy/shuttle{
	dir = 1
	},
/turf/open/floor/mineral/plastitanium/red/brig,
/area/shuttle/escape)
"aM" = (
/obj/structure/table,
/turf/open/floor/mineral/titanium/blue,
/area/shuttle/escape)
"aV" = (
/obj/machinery/door/airlock/titanium{
	name = "Emergency Shuttle Airlock"
	},
/turf/open/floor/plating,
/area/shuttle/escape)
"bd" = (
/obj/machinery/stasis,
/turf/open/floor/mineral/titanium/white,
/area/shuttle/escape)
"bi" = (
/obj/structure/window/reinforced{
	dir = 1
	},
/obj/structure/shuttle/engine/heater,
/turf/open/floor/plating/airless,
/area/shuttle/escape)
"bk" = (
/obj/structure/shuttle/engine/propulsion,
/turf/open/floor/plating/airless,
/area/shuttle/escape)
"bY" = (
/obj/structure/table,
/obj/item/toy/plush/lizardplushie{
	pixel_y = 5
	},
/turf/open/floor/mineral/titanium/blue,
/area/shuttle/escape)
"dJ" = (
/obj/structure/closet/wardrobe/genetics_white,
/turf/open/floor/mineral/titanium,
/area/shuttle/escape)
"ek" = (
/turf/open/floor/wood,
/area/shuttle/escape)
"eU" = (
/obj/structure/flora/tree/jungle,
/turf/open/floor/grass,
/area/shuttle/escape)
"fa" = (
/obj/machinery/status_display/evac,
/turf/closed/wall/mineral/titanium/nodiagonal,
/area/shuttle/escape)
"fH" = (
/obj/effect/fun_balloon/sentience/emergency_shuttle{
	effect_range = 1;
	group_name = "staff onboard NTSS-P4R-T"
	},
/mob/living/carbon/human/species/lizard,
/turf/open/floor/mineral/titanium,
/area/shuttle/escape)
"ga" = (
/turf/open/floor/mineral/titanium/white,
/area/shuttle/escape)
"gg" = (
/obj/machinery/light/small{
	dir = 4
	},
/turf/open/floor/mineral/titanium,
/area/shuttle/escape)
"gD" = (
/obj/effect/turf_decal/trimline/neutral/filled/line{
	dir = 4
	},
/turf/open/floor/wood,
/area/shuttle/escape)
"hu" = (
/obj/machinery/light/small{
	brightness = 3;
	dir = 8
	},
/turf/open/floor/mineral/plastitanium/red/brig,
/area/shuttle/escape)
"iW" = (
/obj/effect/turf_decal/trimline/neutral/filled/line{
	dir = 1
	},
/obj/structure/chair/wood,
/turf/open/floor/wood,
/area/shuttle/escape)
"ku" = (
/obj/structure/window/reinforced/spawner/north,
/obj/structure/flora/ausbushes/brflowers,
/turf/open/floor/grass,
/area/shuttle/escape)
"lt" = (
/obj/structure/table,
/obj/item/storage/firstaid/brute{
	pixel_x = 4;
	pixel_y = 4
	},
/turf/open/floor/mineral/titanium/white,
/area/shuttle/escape)
"me" = (
/obj/machinery/light,
/turf/open/floor/mineral/titanium,
/area/shuttle/escape)
"mz" = (
/obj/structure/window/reinforced/spawner/east,
/obj/structure/window/reinforced/spawner/north,
/mob/living/simple_animal/butterfly,
/turf/open/floor/grass,
/area/shuttle/escape)
"nJ" = (
/obj/machinery/door/airlock,
/turf/open/floor/mineral/titanium,
/area/shuttle/escape)
"pp" = (
/obj/machinery/door/airlock/medical/glass{
	name = "Medbay"
	},
/turf/open/floor/mineral/titanium/white,
/area/shuttle/escape)
"pN" = (
/obj/machinery/vending/autodrobe/all_access,
/turf/open/floor/mineral/titanium,
/area/shuttle/escape)
"qn" = (
/obj/machinery/vending/wallmed{
	name = "Emergency NanoMed";
	use_power = 0
	},
/turf/closed/wall/mineral/titanium,
/area/shuttle/escape)
"rb" = (
/obj/structure/table/wood,
/obj/machinery/light/small{
	dir = 4
	},
/turf/open/floor/wood,
/area/shuttle/escape)
"sb" = (
/obj/effect/turf_decal/tile/bar,
/obj/effect/turf_decal/tile/bar{
	dir = 1
	},
/turf/open/floor/plasteel,
/area/shuttle/escape)
"tk" = (
/obj/effect/turf_decal/tile/bar,
/obj/effect/turf_decal/tile/bar{
	dir = 1
	},
/obj/machinery/door/window/westright,
/turf/open/floor/plasteel,
/area/shuttle/escape)
"tI" = (
/obj/structure/window/reinforced/spawner/east,
/obj/structure/window/reinforced/spawner,
/turf/open/floor/grass,
/area/shuttle/escape)
"vr" = (
/obj/machinery/light/small{
	dir = 1
	},
/turf/open/floor/wood,
/area/shuttle/escape)
"vI" = (
/obj/structure/table,
/obj/item/storage/firstaid/toxin{
	pixel_x = 4;
	pixel_y = 4
	},
/obj/machinery/light/small{
	dir = 4
	},
/turf/open/floor/mineral/titanium/white,
/area/shuttle/escape)
"xy" = (
/obj/structure/window/reinforced/spawner/east,
/turf/open/floor/grass,
/area/shuttle/escape)
"CO" = (
/obj/machinery/jukebox,
/turf/open/floor/wood,
/area/shuttle/escape)
"FZ" = (
/obj/structure/table,
/obj/item/storage/firstaid,
/obj/machinery/light/small{
	brightness = 3;
	dir = 8
	},
/turf/open/floor/mineral/titanium/white,
/area/shuttle/escape)
"Gg" = (
/obj/machinery/door/airlock/titanium{
	name = "Emergency Shuttle Airlock"
	},
/obj/docking_port/mobile/emergency{
	name = "NTSS-P4R-T"
	},
/turf/open/floor/plating,
/area/shuttle/escape)
"GD" = (
/obj/structure/window/reinforced/spawner/north,
/turf/open/floor/grass,
/area/shuttle/escape)
"Hb" = (
/obj/structure/table/wood,
/obj/effect/turf_decal/tile/bar,
/obj/effect/turf_decal/tile/bar{
	dir = 1
	},
/turf/open/floor/plasteel,
/area/shuttle/escape)
"Jp" = (
/obj/structure/window/reinforced/spawner,
/turf/open/floor/grass,
/area/shuttle/escape)
"MC" = (
/obj/structure/table/wood{
	dir = 1
	},
/obj/effect/turf_decal/tile/bar,
/obj/effect/turf_decal/tile/bar{
	dir = 1
	},
/obj/machinery/chem_dispenser/drinks/beer{
	dir = 1
	},
/turf/open/floor/plasteel,
/area/shuttle/escape)
"Nl" = (
/obj/structure/flora/ausbushes/ppflowers,
/turf/open/floor/grass,
/area/shuttle/escape)
"Of" = (
/obj/machinery/light{
	dir = 1
	},
/turf/open/floor/wood,
/area/shuttle/escape)
"OV" = (
/obj/structure/chair/wood{
	dir = 1
	},
/turf/open/floor/wood,
/area/shuttle/escape)
"Pn" = (
/obj/structure/window/reinforced/spawner,
/obj/structure/flora/ausbushes/ywflowers,
/turf/open/floor/grass,
/area/shuttle/escape)
"Rh" = (
/obj/machinery/light{
	dir = 8
	},
/turf/open/floor/wood,
/area/shuttle/escape)
"Rp" = (
/obj/structure/table/wood,
/obj/effect/turf_decal/tile/bar,
/obj/effect/turf_decal/tile/bar{
	dir = 1
	},
/obj/machinery/chem_dispenser/drinks{
	dir = 4
	},
/turf/open/floor/plasteel,
/area/shuttle/escape)
"Um" = (
/obj/machinery/vending/boozeomat/all_access,
/obj/effect/turf_decal/tile/bar,
/obj/effect/turf_decal/tile/bar{
	dir = 1
	},
/turf/open/floor/plasteel,
/area/shuttle/escape)
"US" = (
/obj/effect/turf_decal/trimline/neutral/filled/line{
	dir = 1
	},
/turf/open/floor/wood,
/area/shuttle/escape)
"Vb" = (
/obj/structure/table/wood,
/turf/open/floor/wood,
/area/shuttle/escape)
"Vl" = (
/obj/machinery/light,
/turf/open/floor/wood,
/area/shuttle/escape)
"VS" = (
/obj/structure/chair/comfy/shuttle{
	dir = 1
	},
/turf/open/floor/mineral/titanium,
/area/shuttle/escape)
"Wm" = (
/obj/structure/closet/wardrobe/grey,
/turf/open/floor/mineral/titanium,
/area/shuttle/escape)
"Xb" = (
/obj/structure/chair/wood,
/turf/open/floor/wood,
/area/shuttle/escape)
"XC" = (
/obj/structure/closet/emcloset,
/turf/open/floor/mineral/titanium/white,
/area/shuttle/escape)
"Ys" = (
/obj/structure/closet/wardrobe/mixed,
/turf/open/floor/mineral/titanium,
/area/shuttle/escape)
"Yx" = (
/obj/effect/turf_decal/tile/bar,
/obj/effect/turf_decal/tile/bar{
	dir = 1
	},
/obj/machinery/light/small{
	dir = 4
	},
/turf/open/floor/plasteel,
/area/shuttle/escape)
"Zc" = (
/obj/structure/closet/wardrobe/black,
/turf/open/floor/mineral/titanium,
/area/shuttle/escape)
"Zu" = (
/obj/machinery/light/small{
	brightness = 3;
	dir = 8
	},
/turf/open/floor/mineral/titanium,
/area/shuttle/escape)
"ZO" = (
/turf/open/floor/grass,
/area/shuttle/escape)

(1,1,1) = {"
aa
aa
aa
aa
ad
ad
ad
aI
ad
Gg
ad
ac
ac
ac
ad
aV
ad
aV
ad
ad
ad
aa
"}
(2,1,1) = {"
aa
ad
ad
ad
ad
aA
hu
aG
ad
vr
ek
GD
ZO
Jp
ek
ek
ad
aC
Zu
Zc
ad
ad
"}
(3,1,1) = {"
ad
ae
al
aq
ad
aA
aG
aJ
ad
ek
ek
GD
Nl
Jp
ek
ek
ad
aC
aC
dJ
bi
bk
"}
(4,1,1) = {"
ac
aM
an
an
ad
aA
aG
aJ
ad
ek
ek
GD
eU
Jp
ek
ek
nJ
aC
fH
Wm
bi
bk
"}
(5,1,1) = {"
ac
aM
aC
aC
ad
ac
aH
ac
fa
ek
ek
GD
ZO
Jp
ek
ek
ad
pN
gg
Ys
bi
bk
"}
(6,1,1) = {"
ac
ah
VS
me
ad
Of
ek
ek
Rh
ek
ek
ku
ZO
Pn
ek
Vl
qn
ad
ad
ad
bi
bk
"}
(7,1,1) = {"
ac
aM
aC
aC
ay
gD
gD
gD
af
ek
ek
mz
xy
tI
ek
ek
ac
XC
FZ
lt
bi
bk
"}
(8,1,1) = {"
ac
bY
an
an
ad
tk
Rp
Hb
US
ek
ek
ek
ek
ek
ek
ek
pp
ga
ga
ga
bi
bk
"}
(9,1,1) = {"
ad
ae
ap
au
ad
sb
sb
Hb
US
ek
ek
ek
ek
ek
ek
ek
ac
ga
ga
ga
bi
bk
"}
(10,1,1) = {"
aa
ad
ad
ad
ad
Um
Yx
MC
iW
rb
OV
Xb
Vb
OV
ek
CO
ac
bd
vI
bd
ad
ad
"}
(11,1,1) = {"
aa
aa
aa
aa
ad
ac
ad
ac
ad
ad
ad
ac
ac
ac
ad
ad
ad
ac
ad
ac
ad
aa
"}
